   49   50  149  150  249  250  349  350  449  450  549  550  649  650  749  750  849  850  949  950 1049 1050 1149 1150 1249
   48   51  148  151  248  251  348  351  448  451  548  551  648  651  748  751  848  851  948  951 1048 1051 1148 1151 1248
   47   52  147  152  247  252  347  352  447  452  547  552  647  652  747  752  847  852  947  952 1047 1052 1147 1152 1247
   46   53  146  153  246  253  346  353  446  453  546  553  646  653  746  753  846  853  946  953 1046 1053 1146 1153 1246
   45   54  145  154  245  254  345  354  445  454  545  554  645  654  745  754  845  854  945  954 1045 1054 1145 1154 1245
   44   55  144  155  244  255  344  355  444  455  544  555  644  655  744  755  844  855  944  955 1044 1055 1144 1155 1244
   43   56  143  156  243  256  343  356  443  456  543  556  643  656  743  756  843  856  943  956 1043 1056 1143 1156 1243
   42   57  142  157  242  257  342  357  442  457  542  557  642  657  742  757  842  857  942  957 1042 1057 1142 1157 1242
   41   58  141  158  241  258  341  358  441  458  541  558  641  658  741  758  841  858  941  958 1041 1058 1141 1158 1241
   40   59  140  159  240  259  340  359  440  459  540  559  640  659  740  759  840  859  940  959 1040 1059 1140 1159 1240
   39   60  139  160  239  260  339  360  439  460  539  560  639  660  739  760  839  860  939  960 1039 1060 1139 1160 1239
   38   61  138  161  238  261  338  361  438  461  538  561  638  661  738  761  838  861  938  961 1038 1061 1138 1161 1238
   37   62  137  162  237  262  337  362  437  462  537  562  637  662  737  762  837  862  937  962 1037 1062 1137 1162 1237
   36   63  136  163  236  263  336  363  436  463  536  563  636  663  736  763  836  863  936  963 1036 1063 1136 1163 1236
   35   64  135  164  235  264  335  364  435  464  535  564  635  664  735  764  835  864  935  964 1035 1064 1135 1164 1235
   34   65  134  165  234  265  334  365  434  465  534  565  634  665  734  765  834  865  934  965 1034 1065 1134 1165 1234
   33   66  133  166  233  266  333  366  433  466  533  566  633  666  733  766  833  866  933  966 1033 1066 1133 1166 1233
   32   67  132  167  232  267  332  367  432  467  532  567  632  667  732  767  832  867  932  967 1032 1067 1132 1167 1232
   31   68  131  168  231  268  331  368  431  468  531  568  631  668  731  768  831  868  931  968 1031 1068 1131 1168 1231
   30   69  130  169  230  269  330  369  430  469  530  569  630  669  730  769  830  869  930  969 1030 1069 1130 1169 1230
   29   70  129  170  229  270  329  370  429  470  529  570  629  670  729  770  829  870  929  970 1029 1070 1129 1170 1229
   28   71  128  171  228  271  328  371  428  471  528  571  628  671  728  771  828  871  928  971 1028 1071 1128 1171 1228
   27   72  127  172  227  272  327  372  427  472  527  572  627  672  727  772  827  872  927  972 1027 1072 1127 1172 1227
   26   73  126  173  226  273  326  373  426  473  526  573  626  673  726  773  826  873  926  973 1026 1073 1126 1173 1226
   25   74  125  174  225  274  325  374  425  474  525  574  625  674  725  774  825  874  925  974 1025 1074 1125 1174 1225
   24   75  124  175  224  275  324  375  424  475  524  575  624  675  724  775  824  875  924  975 1024 1075 1124 1175 1224
   23   76  123  176  223  276  323  376  423  476  523  576  623  676  723  776  823  876  923  976 1023 1076 1123 1176 1223
   22   77  122  177  222  277  322  377  422  477  522  577  622  677  722  777  822  877  922  977 1022 1077 1122 1177 1222
   21   78  121  178  221  278  321  378  421  478  521  578  621  678  721  778  821  878  921  978 1021 1078 1121 1178 1221
   20   79  120  179  220  279  320  379  420  479  520  579  620  679  720  779  820  879  920  979 1020 1079 1120 1179 1220
   19   80  119  180  219  280  319  380  419  480  519  580  619  680  719  780  819  880  919  980 1019 1080 1119 1180 1219
   18   81  118  181  218  281  318  381  418  481  518  581  618  681  718  781  818  881  918  981 1018 1081 1118 1181 1218
   17   82  117  182  217  282  317  382  417  482  517  582  617  682  717  782  817  882  917  982 1017 1082 1117 1182 1217
   16   83  116  183  216  283  316  383  416  483  516  583  616  683  716  783  816  883  916  983 1016 1083 1116 1183 1216
   15   84  115  184  215  284  315  384  415  484  515  584  615  684  715  784  815  884  915  984 1015 1084 1115 1184 1215
   14   85  114  185  214  285  314  385  414  485  514  585  614  685  714  785  814  885  914  985 1014 1085 1114 1185 1214
   13   86  113  186  213  286  313  386  413  486  513  586  613  686  713  786  813  886  913  986 1013 1086 1113 1186 1213
   12   87  112  187  212  287  312  387  412  487  512  587  612  687  712  787  812  887  912  987 1012 1087 1112 1187 1212
   11   88  111  188  211  288  311  388  411  488  511  588  611  688  711  788  811  888  911  988 1011 1088 1111 1188 1211
   10   89  110  189  210  289  310  389  410  489  510  589  610  689  710  789  810  889  910  989 1010 1089 1110 1189 1210
    9   90  109  190  209  290  309  390  409  490  509  590  609  690  709  790  809  890  909  990 1009 1090 1109 1190 1209
    8   91  108  191  208  291  308  391  408  491  508  591  608  691  708  791  808  891  908  991 1008 1091 1108 1191 1208
    7   92  107  192  207  292  307  392  407  492  507  592  607  692  707  792  807  892  907  992 1007 1092 1107 1192 1207
    6   93  106  193  206  293  306  393  406  493  506  593  606  693  706  793  806  893  906  993 1006 1093 1106 1193 1206
    5   94  105  194  205  294  305  394  405  494  505  594  605  694  705  794  805  894  905  994 1005 1094 1105 1194 1205
    4   95  104  195  204  295  304  395  404  495  504  595  604  695  704  795  804  895  904  995 1004 1095 1104 1195 1204
    3   96  103  196  203  296  303  396  403  496  503  596  603  696  703  796  803  896  903  996 1003 1096 1103 1196 1203
    2   97  102  197  202  297  302  397  402  497  502  597  602  697  702  797  802  897  902  997 1002 1097 1102 1197 1202
    1   98  101  198  201  298  301  398  401  498  501  598  601  698  701  798  801  898  901  998 1001 1098 1101 1198 1201
    0   99  100  199  200  299  300  399  400  499  500  599  600  699  700  799  800  899  900  999 1000 1099 1100 1199 1200
